1,1,1,1,1,1,1,1,1,1,1,1,1,1,1,1,1,1,1,1,1,1,1,-395,-395,-395,-395,-395,-395,-395,-395,-395,1,1,1,1,1,1,1,1,1,1,1,1,1,1,1,1,1,1,1,1,1,1,1,1,1
1,1,1,1,1,1,1,1,1,1,1,1,1,1,1,1,1,1,1,1,1,1,-395,-395,1,1,1,1,1,1,1,-395,-395,-395,-395,1,1,1,1,1,1,1,1,1,1,1,1,1,1,1,1,1,1,1,1,1,1
1,1,1,1,1,1,1,1,1,1,1,1,-395,-395,-395,-395,1,1,1,1,1,-395,-395,1,1,1,1,1,1,1,1,1,1,1,-395,-395,1,1,1,1,1,1,1,1,1,1,1,1,1,1,1,1,1,1,1,1,1
1,1,1,1,1,1,1,1,1,1,-395,-395,-395,1,1,-395,-395,-395,-395,1,1,-395,1,1,1,1,1,1,1,1,1,1,1,1,1,-395,-395,-395,-395,1,1,1,1,1,1,1,1,1,1,1,1,1,1,1,1,1,1
1,1,1,1,1,-395,-395,-395,-395,-395,-395,1,1,1,1,1,1,1,-395,1,1,-395,1,1,1,1,1,1,1,1,1,1,1,1,1,1,1,1,-395,-395,1,1,1,1,1,1,1,1,1,1,1,1,1,1,1,1,1
1,1,1,1,1,-395,1,1,1,1,1,1,1,1,1,1,1,1,-395,-395,1,-395,1,1,1,1,1,1,1,1,1,1,1,1,1,1,1,1,1,1,-395,1,1,1,1,1,1,1,1,1,1,1,1,1,1,1,1
1,1,1,1,1,-395,1,1,1,1,1,1,1,1,1,1,1,1,1,-395,1,-395,1,1,1,1,1,1,1,1,1,1,1,1,1,1,1,1,1,1,-395,1,1,1,1,1,1,1,1,1,1,1,1,1,1,1,1
1,1,1,1,1,-395,-395,1,1,1,1,1,1,1,1,1,1,1,1,-395,1,-395,1,1,1,1,1,1,1,1,1,1,1,1,1,1,1,1,1,1,-395,1,1,1,1,1,1,1,1,1,1,1,1,1,1,1,1
1,1,1,1,1,1,-395,-395,-395,-395,1,1,1,1,1,1,1,1,1,-395,1,-395,1,1,1,1,1,1,1,1,1,1,1,1,1,1,1,1,1,1,-395,1,1,1,1,1,1,1,1,1,1,1,1,1,1,1,1
1,1,1,1,1,1,1,1,1,-395,-395,1,1,1,1,1,1,1,-395,-395,1,-395,1,1,1,1,1,1,1,1,1,1,1,1,1,1,1,1,1,1,-395,1,1,1,1,1,1,1,1,1,1,1,1,1,1,1,1
1,1,1,1,1,1,1,1,1,1,-395,1,1,1,1,1,1,-395,-395,1,1,1,-395,-395,-395,-395,-395,-395,-395,-395,1,1,-395,-395,-395,-395,-395,-395,-395,-395,1,1,1,1,1,1,1,1,1,1,1,1,1,1,1,1,1
1,1,1,1,1,1,1,1,1,1,-395,-395,1,1,1,1,1,-395,1,1,1,1,-395,1,1,1,1,1,1,-395,1,1,-395,1,1,1,1,1,1,-395,1,1,1,1,1,1,1,1,1,1,1,1,1,1,1,1,1
1,1,1,1,1,1,1,1,1,1,1,-395,1,1,1,1,1,-395,-395,-395,-395,-395,-395,-395,-395,-395,-395,-395,-395,-395,1,1,-395,-395,-395,-395,-395,-395,-395,-395,-395,-395,-395,-395,-395,-395,1,1,1,1,1,1,1,1,1,1,1
1,1,1,1,1,1,1,1,1,1,-395,-395,1,1,1,1,1,1,1,1,1,1,1,1,1,1,1,1,1,1,1,1,1,1,1,1,1,1,1,1,1,1,1,1,1,-395,1,1,1,1,1,1,1,1,1,1,1
1,1,1,1,1,1,1,1,1,1,-395,1,1,1,1,1,1,1,1,1,1,1,1,1,1,1,1,1,1,1,1,1,1,1,1,1,1,1,1,1,1,1,1,1,1,-395,1,1,1,1,1,1,1,1,1,1,1
1,1,1,1,1,1,1,1,-395,-395,-395,1,1,1,1,1,1,1,1,1,1,1,1,1,1,1,1,1,1,1,1,1,1,1,1,1,1,1,1,1,1,1,1,1,1,-395,1,1,1,1,1,1,1,1,1,1,1
1,1,1,1,1,1,1,1,-395,1,1,1,1,1,1,1,1,1,1,1,1,1,1,1,1,1,1,1,1,1,1,1,1,1,1,1,1,1,1,1,1,1,1,1,1,-395,-395,1,1,1,1,1,1,1,1,1,1
1,1,1,1,1,1,1,-395,-395,1,1,1,1,1,1,1,1,1,1,1,1,1,1,1,1,1,1,1,1,1,1,1,1,1,1,1,1,1,1,1,1,1,1,1,1,1,-395,-395,1,1,1,1,1,1,1,1,1
1,1,1,1,1,1,1,-395,1,1,1,1,1,1,1,1,1,1,1,1,1,1,1,1,1,1,1,1,1,1,1,1,1,1,1,1,1,1,1,1,1,1,1,1,1,1,1,-395,-395,-395,1,1,1,1,1,1,1
1,1,1,1,1,1,-395,-395,1,1,1,1,1,1,1,1,1,1,1,1,1,1,1,1,1,1,1,1,1,1,1,1,1,1,1,1,1,1,1,1,1,1,1,1,1,1,1,1,1,-395,1,1,1,1,1,1,1
1,1,1,1,1,-395,-395,1,1,1,1,1,1,1,1,1,1,1,1,1,1,1,1,1,1,1,1,1,1,1,1,1,1,1,1,1,1,1,1,1,1,1,1,1,1,1,1,1,1,-395,1,1,1,1,1,1,1
1,1,1,1,1,-395,1,1,1,1,1,1,1,1,1,1,1,1,1,1,1,1,1,1,1,1,1,1,1,1,1,1,1,1,1,1,1,1,1,1,1,1,1,1,1,1,1,1,1,-395,1,1,1,1,1,1,1
1,1,1,1,-395,-395,1,1,1,1,1,1,1,1,1,1,1,1,1,1,1,1,1,1,1,1,1,1,1,1,1,1,1,1,1,1,1,1,1,1,1,1,1,1,1,1,1,1,1,-395,1,1,1,1,1,1,1
1,1,1,1,-395,1,1,1,1,1,1,1,1,1,1,1,1,1,1,1,1,1,1,1,1,1,1,1,1,1,1,1,1,1,1,1,1,1,1,1,1,1,1,1,1,1,1,1,1,-395,1,1,1,1,1,1,1
1,1,1,1,-395,1,1,1,1,1,1,1,1,1,1,1,1,1,1,1,1,1,1,1,1,1,1,1,1,1,1,1,1,1,1,1,1,1,1,1,1,1,1,1,1,1,1,1,1,-395,1,1,1,1,1,1,1
1,1,1,1,-395,1,1,1,1,1,1,1,1,1,1,1,1,1,1,1,1,1,1,1,1,1,1,1,1,1,1,1,1,1,1,1,1,1,1,1,1,1,1,1,1,1,1,1,1,-395,1,1,1,1,1,1,1
1,1,1,1,-395,1,1,1,1,1,1,1,1,1,1,1,1,1,1,1,1,1,1,1,1,1,1,1,1,1,1,1,1,1,1,1,1,1,1,1,1,1,1,1,1,1,1,1,-395,-395,1,1,1,1,1,1,1
1,1,1,1,-395,1,1,1,1,1,1,1,1,1,1,1,1,1,1,1,1,1,1,1,1,1,1,1,1,1,1,1,1,1,1,1,1,1,1,1,1,1,1,1,1,1,1,1,-395,1,1,1,1,1,1,1,1
1,1,1,1,-395,-395,1,1,1,1,1,1,1,1,1,1,1,1,1,1,1,1,1,1,1,1,1,1,1,1,1,1,1,1,1,1,1,1,1,1,1,1,1,1,1,1,1,1,-395,1,1,1,1,1,1,1,1
1,1,1,1,1,-395,1,1,1,1,1,1,1,1,1,1,1,1,1,1,1,1,1,1,1,1,1,1,1,1,1,1,1,1,1,1,1,1,1,1,1,1,1,1,1,1,1,-395,-395,1,1,1,1,1,1,1,1
1,1,1,1,1,-395,1,1,1,1,1,1,1,1,1,1,1,1,1,1,1,1,1,1,1,1,1,1,1,1,1,1,1,1,1,1,1,1,1,1,1,1,1,1,1,1,-395,-395,1,1,1,1,1,1,1,1,1
1,1,1,1,1,-395,1,1,1,1,1,1,1,1,1,1,1,1,1,1,1,1,1,1,1,1,1,1,1,1,1,1,1,1,1,1,1,1,1,1,1,1,1,1,-395,-395,-395,1,1,1,1,1,1,1,1,1,1
1,1,1,1,1,-395,-395,-395,1,1,1,1,1,1,1,1,1,1,1,1,1,1,1,1,1,1,1,1,1,1,1,1,1,1,1,1,1,1,1,1,1,1,1,-395,-395,1,1,1,1,-395,-395,-395,1,1,1,1,1
1,1,1,1,1,1,1,-395,-395,1,1,1,1,1,1,1,1,1,1,1,1,1,1,1,1,1,1,1,1,1,1,1,1,1,1,1,1,1,1,1,1,1,-395,-395,1,1,1,1,-395,-395,1,-395,1,1,1,1,1
1,1,1,1,1,1,1,1,-395,-395,1,1,1,1,1,1,1,1,1,1,1,1,1,1,1,1,1,1,1,1,1,1,1,1,-395,-395,-395,1,1,-395,-395,-395,-395,1,1,1,1,-395,-395,1,1,-395,1,1,1,1,1
1,1,1,1,1,1,1,1,1,-395,-395,-395,1,1,1,1,1,1,1,1,1,1,1,1,1,1,1,1,1,1,1,1,-395,-395,-395,1,-395,1,1,-395,1,1,1,1,1,1,-395,-395,1,1,1,-395,1,1,1,1,1
1,1,1,1,1,1,1,1,1,1,1,-395,-395,-395,1,1,1,1,1,1,1,1,1,1,1,1,1,1,1,1,1,-395,-395,1,1,1,-395,1,1,-395,1,1,1,1,-395,-395,-395,1,1,1,1,-395,1,1,1,1,1
1,1,1,1,1,1,1,1,1,1,1,1,1,-395,1,1,1,1,1,1,1,1,1,1,1,1,1,1,1,1,-395,-395,1,1,1,1,-395,1,1,-395,1,1,-395,-395,-395,1,1,1,1,1,1,-395,1,1,1,1,1
1,1,1,1,1,1,1,1,1,1,1,1,1,-395,1,1,1,1,1,1,1,1,1,1,1,1,1,1,1,1,-395,1,1,1,-395,-395,-395,1,1,-395,-395,-395,-395,1,1,1,1,1,1,1,1,-395,1,1,1,1,1
1,1,1,1,1,1,1,1,1,1,1,1,1,-395,1,1,1,1,1,1,1,1,1,1,1,1,1,1,1,-395,-395,1,1,1,-395,1,1,1,1,1,1,1,1,1,1,1,1,1,1,1,1,-395,-395,1,1,1,1
1,1,1,1,1,1,1,1,1,1,1,1,1,-395,-395,1,1,1,1,1,1,1,1,1,1,1,1,1,-395,-395,1,1,1,-395,-395,1,1,1,1,1,1,1,1,1,1,1,1,1,1,1,1,1,-395,1,1,1,1
1,1,1,1,1,1,1,1,1,1,1,1,1,1,-395,-395,1,1,1,1,1,1,1,1,1,-395,-395,-395,-395,1,1,1,-395,-395,1,1,1,1,1,1,1,1,1,1,1,1,1,1,1,1,1,1,-395,1,1,1,1
1,1,1,1,1,1,1,1,1,1,1,1,1,1,1,-395,-395,1,1,1,1,1,1,1,1,-395,1,1,1,1,1,-395,-395,1,1,1,1,1,1,1,1,1,1,1,1,1,1,1,1,1,1,-395,-395,1,1,1,1
1,1,1,1,1,1,1,1,1,1,1,1,1,1,1,1,-395,-395,-395,-395,-395,-395,-395,-395,-395,-395,1,1,1,1,-395,-395,1,1,1,1,1,1,1,1,1,1,1,1,1,1,1,1,1,1,1,-395,1,1,1,1,1
1,1,1,1,1,1,1,1,1,1,1,1,1,1,1,1,1,1,1,1,1,1,1,1,1,1,1,1,1,-395,-395,1,1,1,1,1,1,1,1,1,1,1,1,1,1,1,1,1,1,1,1,-395,1,1,1,1,1
1,1,1,1,1,1,1,1,1,1,1,1,1,1,1,1,1,1,1,1,1,1,1,1,1,1,1,1,1,-395,1,1,1,1,1,1,1,1,1,1,1,1,1,1,1,1,1,1,1,1,-395,-395,1,1,1,1,1
1,1,1,1,1,1,1,1,1,1,1,1,1,1,1,1,1,1,1,1,1,1,1,1,1,1,1,1,1,-395,-395,-395,-395,-395,-395,1,1,-395,-395,-395,1,1,1,1,1,1,1,1,1,1,-395,1,1,1,1,1,1
1,1,1,1,1,1,1,1,1,1,1,1,1,1,1,1,1,1,1,1,1,1,1,1,1,1,1,1,1,1,1,1,1,1,-395,-395,-395,-395,1,-395,-395,-395,-395,-395,-395,-395,-395,-395,1,-395,-395,1,1,1,1,1,1
1,1,1,1,1,1,1,1,1,1,1,1,1,1,1,1,1,1,1,1,1,1,1,1,1,1,1,1,1,1,1,1,1,1,1,1,1,1,1,1,1,1,1,1,1,1,1,-395,-395,-395,1,1,1,1,1,1,1
1,1,1,1,1,1,1,1,1,1,1,1,1,1,1,1,1,1,1,1,1,1,1,1,1,1,1,1,1,1,1,1,1,1,1,1,1,1,1,1,1,1,1,1,1,1,1,1,1,1,1,1,1,1,1,1,1
